#############################
###########.........#.......#
#...#..#....#######.#.#####.#
#.#.##.#.########...#.#######
#.#.##.#..##...######......##
#.#....##.##.#.####.######.##
#.#.#####.##.#.####.######.##
#.#.###......#...##.#####..##
#.#.###.####.######.......###
#.#.#.######.######.#####.###
#.#.#.######.##..##.#####...x
#.#.#.###....##.###.#########
#.#.....#.#####.###.#....####
#.#####...#####...#...##.####
#....##.###...###.######...##
####.#..###.#.###......###.##
##...#.####.#...######.###.##
o..###.####.###....###.....##
####...##.#.######...#####.##
####.#.##.#.##..##.#.#####.##
####.#.##.#..#.###.#.##....##
##...#.##.##.#.#...#..#.#####
######.......#...####...#####
#############################
